#########################
#o.....................o#
#o.........}...........o#
#.######.........######.#
 .#    #.### ###.#    #. 
#.#    #.#     #.#    #.# 
#.######.#######.######.#
#o..M..................o#
#########################
