###############################
#o...{?M.....................o#
#.######.##.###.###.##.######.#
 .#    #.##.### ###.##.#    #. 
 .#    #.##.#     #.##.#    #. 
#.######.##.#######.##.######.#
#o.........{............MM...o#
###############################
