#########################
#o.......}.............o#
#.######.........######.#
 .#    #.### ###.#    #. 
 .#    #.#     #.#    #. 
#.######.#######.######.#
#o.....................o#
#########################
