############################
#............##............#
#o####..###..##..###..####o#
#................}.........#
#.####.##..######..##.####.#
#......##....##....##......#
#......##          ##......#
######.## ###  ### ##.######
....o..   #  MM   #   ..o....  
######.## ######## ##.######
#......##          ##......#
#......##.########.##......#
#.###..##.########.##..###.#
#............o.............#
#o###..####..##..####..###o#
#............##............#
############################
